12	11
XXXXXXXXXXX
XS        X
XXXXX XXXXX
X   X X   X
XXX     XXX
X XXX XXX X
X   X X   X
X   X X   X
X X X X X X
X X     X X
X  XX XXEXX
XXXXXXXXXXX
